"filename", "language", "YAML", "XML", "JSON", "Markdown", "C#", "comment", "blank", "total"
"d:\Hexalith\Hexalith\.github\workflows\preview_ci.yml", "YAML", 45, 0, 0, 0, 0, 0, 0, 45
"d:\Hexalith\Hexalith\.github\workflows\release_ci.yml", "YAML", 46, 0, 0, 0, 0, 0, 0, 46
"d:\Hexalith\Hexalith\.github\workflows\semgrep.yml", "YAML", 22, 0, 0, 0, 0, 0, 1, 23
"d:\Hexalith\Hexalith\.github\workflows\sonarqube.yml", "YAML", 48, 0, 0, 0, 0, 0, 1, 49
"d:\Hexalith\Hexalith\.readthedocs.yaml", "YAML", 12, 0, 0, 0, 0, 7, 6, 25
"d:\Hexalith\Hexalith\.stylecop.json", "JSON", 0, 0, 18, 0, 0, 5, 1, 24
"d:\Hexalith\Hexalith\CODE-OF-CONDUCT.md", "Markdown", 0, 0, 0, 3, 0, 0, 1, 4
"d:\Hexalith\Hexalith\Directory.Build.props", "XML", 0, 37, 0, 0, 0, 0, 1, 38
"d:\Hexalith\Hexalith\README.md", "Markdown", 0, 0, 0, 45, 0, 0, 24, 69
"d:\Hexalith\Hexalith\docs\Hexalith.Docs.csproj", "XML", 0, 9, 0, 0, 0, 0, 1, 10
"d:\Hexalith\Hexalith\docs\getting-started\create-application.md", "Markdown", 0, 0, 0, 26, 0, 0, 17, 43
"d:\Hexalith\Hexalith\docs\getting-started\preview-package-source.md", "Markdown", 0, 0, 0, 17, 0, 0, 9, 26
"d:\Hexalith\Hexalith\docs\index.md", "Markdown", 0, 0, 0, 4, 0, 0, 4, 8
"d:\Hexalith\Hexalith\environment.yaml", "YAML", 8, 0, 0, 0, 0, 0, 1, 9
"d:\Hexalith\Hexalith\mkdocs.yml", "YAML", 10, 0, 0, 0, 0, 0, 2, 12
"d:\Hexalith\Hexalith\src\Core\Application\Hexalith.Application.Abstractions\Aggregates\IAggregateStateManager.cs", "C#", 0, 0, 0, 0, 11, 35, 8, 54
"d:\Hexalith\Hexalith\src\Core\Application\Hexalith.Application.Abstractions\Commands\BaseCommand.cs", "C#", 0, 0, 0, 0, 7, 12, 5, 24
"d:\Hexalith\Hexalith\src\Core\Application\Hexalith.Application.Abstractions\Commands\CommandHandler.cs", "C#", 0, 0, 0, 0, 25, 21, 9, 55
"d:\Hexalith\Hexalith\src\Core\Application\Hexalith.Application.Abstractions\Commands\ICommand.cs", "C#", 0, 0, 0, 0, 5, 8, 3, 16
"d:\Hexalith\Hexalith\src\Core\Application\Hexalith.Application.Abstractions\Commands\ICommandDispatcher.cs", "C#", 0, 0, 0, 0, 7, 20, 5, 32
"d:\Hexalith\Hexalith\src\Core\Application\Hexalith.Application.Abstractions\Commands\ICommandEnvelope.cs", "C#", 0, 0, 0, 0, 13, 21, 5, 39
"d:\Hexalith\Hexalith\src\Core\Application\Hexalith.Application.Abstractions\Commands\ICommandHandler.cs", "C#", 0, 0, 0, 0, 16, 35, 8, 59
"d:\Hexalith\Hexalith\src\Core\Application\Hexalith.Application.Abstractions\Commands\ICommandProcessor.cs", "C#", 0, 0, 0, 0, 8, 15, 5, 28
"d:\Hexalith\Hexalith\src\Core\Application\Hexalith.Application.Abstractions\Commands\ICommandSaga.cs", "C#", 0, 0, 0, 0, 4, 8, 2, 14
"d:\Hexalith\Hexalith\src\Core\Application\Hexalith.Application.Abstractions\Envelopes\BaseEnvelope.cs", "C#", 0, 0, 0, 0, 23, 17, 9, 49
"d:\Hexalith\Hexalith\src\Core\Application\Hexalith.Application.Abstractions\Envelopes\Envelope.cs", "C#", 0, 0, 0, 0, 14, 10, 5, 29
"d:\Hexalith\Hexalith\src\Core\Application\Hexalith.Application.Abstractions\Envelopes\EventEnvelope.cs", "C#", 0, 0, 0, 0, 20, 21, 7, 48
"d:\Hexalith\Hexalith\src\Core\Application\Hexalith.Application.Abstractions\Envelopes\IEnvelope.cs", "C#", 0, 0, 0, 0, 19, 29, 7, 55
"d:\Hexalith\Hexalith\src\Core\Application\Hexalith.Application.Abstractions\Envelopes\IMessageBus.cs", "C#", 0, 0, 0, 0, 10, 23, 6, 39
"d:\Hexalith\Hexalith\src\Core\Application\Hexalith.Application.Abstractions\Errors\ApplicationErrorException.cs", "C#", 0, 0, 0, 0, 33, 39, 10, 82
"d:\Hexalith\Hexalith\src\Core\Application\Hexalith.Application.Abstractions\Errors\ApplicationResult.cs", "C#", 0, 0, 0, 0, 23, 43, 9, 75
"d:\Hexalith\Hexalith\src\Core\Application\Hexalith.Application.Abstractions\Errors\Error.cs", "C#", 0, 0, 0, 0, 11, 32, 9, 52
"d:\Hexalith\Hexalith\src\Core\Application\Hexalith.Application.Abstractions\Events\EventDeserializationFailed.cs", "C#", 0, 0, 0, 0, 21, 19, 6, 46
"d:\Hexalith\Hexalith\src\Core\Application\Hexalith.Application.Abstractions\Events\EventDispatchFailed.cs", "C#", 0, 0, 0, 0, 28, 10, 6, 44
"d:\Hexalith\Hexalith\src\Core\Application\Hexalith.Application.Abstractions\Events\EventNotImplementedInDispatcher.cs", "C#", 0, 0, 0, 0, 14, 9, 5, 28
"d:\Hexalith\Hexalith\src\Core\Application\Hexalith.Application.Abstractions\Events\EventValidationFailed.cs", "C#", 0, 0, 0, 0, 21, 19, 6, 46
"d:\Hexalith\Hexalith\src\Core\Application\Hexalith.Application.Abstractions\Events\IEventEnvelope.cs", "C#", 0, 0, 0, 0, 14, 11, 5, 30
"d:\Hexalith\Hexalith\src\Core\Application\Hexalith.Application.Abstractions\Events\IIntegrationEventDispatcher.cs", "C#", 0, 0, 0, 0, 7, 14, 4, 25
"d:\Hexalith\Hexalith\src\Core\Application\Hexalith.Application.Abstractions\Events\IIntegrationEventHandler.cs", "C#", 0, 0, 0, 0, 14, 24, 6, 44
"d:\Hexalith\Hexalith\src\Core\Application\Hexalith.Application.Abstractions\Events\IIntegrationEventProcessor.cs", "C#", 0, 0, 0, 0, 7, 14, 5, 26
"d:\Hexalith\Hexalith\src\Core\Application\Hexalith.Application.Abstractions\Events\IntegrationEventHandler.cs", "C#", 0, 0, 0, 0, 20, 19, 7, 46
"d:\Hexalith\Hexalith\src\Core\Application\Hexalith.Application.Abstractions\Exceptions\DuplicateEntityFoundException.cs", "C#", 0, 0, 0, 0, 29, 38, 9, 76
"d:\Hexalith\Hexalith\src\Core\Application\Hexalith.Application.Abstractions\Exceptions\EntityNotFoundException.cs", "C#", 0, 0, 0, 0, 29, 38, 9, 76
"d:\Hexalith\Hexalith\src\Core\Application\Hexalith.Application.Abstractions\Helpers\LogErrorHelper.cs", "C#", 0, 0, 0, 0, 15, 13, 6, 34
"d:\Hexalith\Hexalith\src\Core\Application\Hexalith.Application.Abstractions\Hexalith.Application.Abstractions.csproj", "XML", 0, 17, 0, 0, 0, 0, 1, 18
"d:\Hexalith\Hexalith\src\Core\Application\Hexalith.Application.Abstractions\Metadatas\AggregateMetadata.cs", "C#", 0, 0, 0, 0, 20, 22, 7, 49
"d:\Hexalith\Hexalith\src\Core\Application\Hexalith.Application.Abstractions\Metadatas\ContextMetadata.cs", "C#", 0, 0, 0, 0, 31, 34, 12, 77
"d:\Hexalith\Hexalith\src\Core\Application\Hexalith.Application.Abstractions\Metadatas\IAggregateMetaData.cs", "C#", 0, 0, 0, 0, 6, 14, 3, 23
"d:\Hexalith\Hexalith\src\Core\Application\Hexalith.Application.Abstractions\Metadatas\IContextMetadata.cs", "C#", 0, 0, 0, 0, 9, 23, 7, 39
"d:\Hexalith\Hexalith\src\Core\Application\Hexalith.Application.Abstractions\Metadatas\IMessageMetadata.cs", "C#", 0, 0, 0, 0, 9, 23, 7, 39
"d:\Hexalith\Hexalith\src\Core\Application\Hexalith.Application.Abstractions\Metadatas\IMessageVersion.cs", "C#", 0, 0, 0, 0, 6, 14, 3, 23
"d:\Hexalith\Hexalith\src\Core\Application\Hexalith.Application.Abstractions\Metadatas\IMetadata.cs", "C#", 0, 0, 0, 0, 8, 20, 6, 34
"d:\Hexalith\Hexalith\src\Core\Application\Hexalith.Application.Abstractions\Metadatas\IMetadataVersion.cs", "C#", 0, 0, 0, 0, 6, 14, 3, 23
"d:\Hexalith\Hexalith\src\Core\Application\Hexalith.Application.Abstractions\Metadatas\MessageMetadata.cs", "C#", 0, 0, 0, 0, 40, 21, 12, 73
"d:\Hexalith\Hexalith\src\Core\Application\Hexalith.Application.Abstractions\Metadatas\MessageVersion.cs", "C#", 0, 0, 0, 0, 23, 24, 7, 54
"d:\Hexalith\Hexalith\src\Core\Application\Hexalith.Application.Abstractions\Metadatas\Metadata.cs", "C#", 0, 0, 0, 0, 65, 51, 16, 132
"d:\Hexalith\Hexalith\src\Core\Application\Hexalith.Application.Abstractions\Metadatas\MetadataVersion.cs", "C#", 0, 0, 0, 0, 23, 24, 7, 54
"d:\Hexalith\Hexalith\src\Core\Application\Hexalith.Application.Abstractions\README.md", "Markdown", 0, 0, 0, 3, 0, 0, 2, 5
"d:\Hexalith\Hexalith\src\Core\Application\Hexalith.Application.Abstractions\States\IStateStoreProvider.cs", "C#", 0, 0, 0, 0, 10, 35, 8, 53
"d:\Hexalith\Hexalith\src\Core\Application\Hexalith.Application.Abstractions\StreamStores\IDataFragment.cs", "C#", 0, 0, 0, 0, 11, 23, 5, 39
"d:\Hexalith\Hexalith\src\Core\Application\Hexalith.Application.Abstractions\StreamStores\IPersistedStream.cs", "C#", 0, 0, 0, 0, 8, 29, 5, 42
"d:\Hexalith\Hexalith\src\Core\Application\Hexalith.Application.Abstractions\StreamStores\IStreamItem.cs", "C#", 0, 0, 0, 0, 6, 14, 3, 23
"d:\Hexalith\Hexalith\src\Core\Application\Hexalith.Application.Abstractions\StreamStores\IStreamStore.cs", "C#", 0, 0, 0, 0, 5, 13, 2, 20
"d:\Hexalith\Hexalith\src\Core\Application\Hexalith.Application.Abstractions\Tasks\ITaskProcessor.cs", "C#", 0, 0, 0, 0, 14, 45, 11, 70
"d:\Hexalith\Hexalith\src\Core\Application\Hexalith.Application.Abstractions\Tasks\InvalidStatusChangeException.cs", "C#", 0, 0, 0, 0, 30, 37, 9, 76
"d:\Hexalith\Hexalith\src\Core\Application\Hexalith.Application.Abstractions\Tasks\ResiliencyPolicy.cs", "C#", 0, 0, 0, 0, 70, 62, 19, 151
"d:\Hexalith\Hexalith\src\Core\Application\Hexalith.Application.Abstractions\Tasks\RetryStatus.cs", "C#", 0, 0, 0, 0, 7, 17, 4, 28
"d:\Hexalith\Hexalith\src\Core\Application\Hexalith.Application.Abstractions\Tasks\TaskProcessingFailure.cs", "C#", 0, 0, 0, 0, 28, 31, 8, 67
"d:\Hexalith\Hexalith\src\Core\Application\Hexalith.Application.Abstractions\Tasks\TaskProcessingHistory.cs", "C#", 0, 0, 0, 0, 75, 50, 13, 138
"d:\Hexalith\Hexalith\src\Core\Application\Hexalith.Application.Abstractions\Tasks\TaskProcessor.cs", "C#", 0, 0, 0, 0, 146, 42, 23, 211
"d:\Hexalith\Hexalith\src\Core\Application\Hexalith.Application.Abstractions\Tasks\TaskProcessorStatus.cs", "C#", 0, 0, 0, 0, 9, 23, 6, 38
"d:\Hexalith\Hexalith\src\Core\Application\Hexalith.Application\Commands\DependencyInjectionCommandDispatcher.cs", "C#", 0, 0, 0, 0, 39, 29, 12, 80
"d:\Hexalith\Hexalith\src\Core\Application\Hexalith.Application\DataFragment.cs", "C#", 0, 0, 0, 0, 21, 23, 7, 51
"d:\Hexalith\Hexalith\src\Core\Application\Hexalith.Application\Events\DependencyInjectionEventDispatcher.cs", "C#", 0, 0, 0, 0, 37, 27, 11, 75
"d:\Hexalith\Hexalith\src\Core\Application\Hexalith.Application\Hexalith.Application.csproj", "XML", 0, 8, 0, 0, 0, 0, 1, 9
"d:\Hexalith\Hexalith\src\Core\Application\Hexalith.Application\README.md", "Markdown", 0, 0, 0, 1, 0, 0, 2, 3
"d:\Hexalith\Hexalith\src\Core\Application\Hexalith.Application\StreamStores\JsonStreamItem.cs", "C#", 0, 0, 0, 0, 71, 52, 15, 138
"d:\Hexalith\Hexalith\src\Core\Application\Hexalith.Application\StreamStores\MemoryPersistedStream.cs", "C#", 0, 0, 0, 0, 38, 12, 9, 59
"d:\Hexalith\Hexalith\src\Core\Application\Hexalith.Application\StreamStores\MemoryStreamStore.cs", "C#", 0, 0, 0, 0, 15, 13, 5, 33
"d:\Hexalith\Hexalith\src\Core\Application\Hexalith.Application\StreamStores\StreamItem.cs", "C#", 0, 0, 0, 0, 23, 21, 7, 51
"d:\Hexalith\Hexalith\src\Core\Application\Hexalith.Application\StreamStores\UnexpectedStreamVersionException.cs", "C#", 0, 0, 0, 0, 42, 43, 10, 95
"d:\Hexalith\Hexalith\src\Core\Application\Hexalith.Application\TaskManager\CommandTask.cs", "C#", 0, 0, 0, 0, 9, 18, 3, 30
"d:\Hexalith\Hexalith\src\Core\Application\README.md", "Markdown", 0, 0, 0, 3, 0, 0, 2, 5
"d:\Hexalith\Hexalith\src\Core\Common\Hexalith.Extensions\Common\ConditionalValue.cs", "C#", 0, 0, 0, 0, 17, 30, 7, 54
"d:\Hexalith\Hexalith\src\Core\Common\Hexalith.Extensions\Common\DateTimeService.cs", "C#", 0, 0, 0, 0, 7, 10, 4, 21
"d:\Hexalith\Hexalith\src\Core\Common\Hexalith.Extensions\Common\IDateTimeService.cs", "C#", 0, 0, 0, 0, 7, 14, 4, 25
"d:\Hexalith\Hexalith\src\Core\Common\Hexalith.Extensions\Configuration\ISettings.cs", "C#", 0, 0, 0, 0, 5, 12, 2, 19
"d:\Hexalith\Hexalith\src\Core\Common\Hexalith.Extensions\Configuration\OptionsHelper.cs", "C#", 0, 0, 0, 0, 12, 15, 3, 30
"d:\Hexalith\Hexalith\src\Core\Common\Hexalith.Extensions\Configuration\README..md", "Markdown", 0, 0, 0, 45, 0, 0, 15, 60
"d:\Hexalith\Hexalith\src\Core\Common\Hexalith.Extensions\Helpers\ArrayHelper.cs", "C#", 0, 0, 0, 0, 8, 14, 2, 24
"d:\Hexalith\Hexalith\src\Core\Common\Hexalith.Extensions\Helpers\DateHelper.cs", "C#", 0, 0, 0, 0, 16, 19, 6, 41
"d:\Hexalith\Hexalith\src\Core\Common\Hexalith.Extensions\Helpers\ExceptionHelper.cs", "C#", 0, 0, 0, 0, 22, 13, 5, 40
"d:\Hexalith\Hexalith\src\Core\Common\Hexalith.Extensions\Helpers\FibonacciSequence.cs", "C#", 0, 0, 0, 0, 29, 14, 7, 50
"d:\Hexalith\Hexalith\src\Core\Common\Hexalith.Extensions\Helpers\README..md", "Markdown", 0, 0, 0, 5, 0, 0, 1, 6
"d:\Hexalith\Hexalith\src\Core\Common\Hexalith.Extensions\Helpers\StringHelper.cs", "C#", 0, 0, 0, 0, 37, 48, 11, 96
"d:\Hexalith\Hexalith\src\Core\Common\Hexalith.Extensions\Helpers\UniqueIdHelper.cs.cs", "C#", 0, 0, 0, 0, 27, 16, 6, 49
"d:\Hexalith\Hexalith\src\Core\Common\Hexalith.Extensions\Hexalith.Extensions.csproj", "XML", 0, 9, 0, 0, 0, 0, 1, 10
"d:\Hexalith\Hexalith\src\Core\Common\Hexalith.Extensions\README.md", "Markdown", 0, 0, 0, 5, 0, 0, 2, 7
"d:\Hexalith\Hexalith\src\Core\Common\Hexalith.Extensions\Serialization\JsonPolymorphicBaseClassAttribute.cs", "C#", 0, 0, 0, 0, 11, 17, 6, 34
"d:\Hexalith\Hexalith\src\Core\Common\Hexalith.Extensions\Serialization\README..md", "Markdown", 0, 0, 0, 21, 0, 0, 3, 24
"d:\Hexalith\Hexalith\src\Core\Common\Hexalith.TestMocks\Hexalith.TestMocks.csproj", "XML", 0, 18, 0, 0, 0, 0, 1, 19
"d:\Hexalith\Hexalith\src\Core\Common\Hexalith.TestMocks\HttpClientFactoryBuilder.cs", "C#", 0, 0, 0, 0, 51, 26, 11, 88
"d:\Hexalith\Hexalith\src\Core\Common\Hexalith.TestMocks\IMockBuilder.cs", "C#", 0, 0, 0, 0, 8, 17, 4, 29
"d:\Hexalith\Hexalith\src\Core\Common\Hexalith.TestMocks\LoggerBuilder.cs", "C#", 0, 0, 0, 0, 14, 17, 5, 36
"d:\Hexalith\Hexalith\src\Core\Common\Hexalith.TestMocks\OptionsBuilder.cs", "C#", 0, 0, 0, 0, 43, 31, 13, 87
"d:\Hexalith\Hexalith\src\Core\Common\README.md", "Markdown", 0, 0, 0, 5, 0, 0, 2, 7
"d:\Hexalith\Hexalith\src\Core\Directory.Build.props", "XML", 0, 10, 0, 0, 0, 0, 0, 10
"d:\Hexalith\Hexalith\src\Core\Domain\Hexalith.Domain.Abstractions\Events\BaseEvent.cs", "C#", 0, 0, 0, 0, 7, 15, 6, 28
"d:\Hexalith\Hexalith\src\Core\Domain\Hexalith.Domain.Abstractions\Events\IEvent.cs", "C#", 0, 0, 0, 0, 5, 8, 3, 16
"d:\Hexalith\Hexalith\src\Core\Domain\Hexalith.Domain.Abstractions\Hexalith.Domain.Abstractions.csproj", "XML", 0, 8, 0, 0, 0, 0, 1, 9
"d:\Hexalith\Hexalith\src\Core\Domain\Hexalith.Domain.Abstractions\Messages\BaseMessage.cs", "C#", 0, 0, 0, 0, 39, 36, 15, 90
"d:\Hexalith\Hexalith\src\Core\Domain\Hexalith.Domain.Abstractions\Messages\IMessage.cs", "C#", 0, 0, 0, 0, 9, 23, 6, 38
"d:\Hexalith\Hexalith\src\Core\Domain\Hexalith.Domain.Abstractions\README.md", "Markdown", 0, 0, 0, 1, 0, 0, 2, 3
"d:\Hexalith\Hexalith\src\Core\Domain\README.md", "Markdown", 0, 0, 0, 2, 0, 0, 2, 4
"d:\Hexalith\Hexalith\src\Core\Infrastructure\Hexalith.Infrastructure.AzureActiveDirectory\AzureActiveDirectoryApplicationSecurityContext.cs", "C#", 0, 0, 0, 0, 61, 14, 10, 85
"d:\Hexalith\Hexalith\src\Core\Infrastructure\Hexalith.Infrastructure.AzureActiveDirectory\Configurations\AzureActiveDirectoryApplicationSecurityContextConfiguration.cs", "C#", 0, 0, 0, 0, 7, 17, 4, 28
"d:\Hexalith\Hexalith\src\Core\Infrastructure\Hexalith.Infrastructure.AzureActiveDirectory\Hexalith.Infrastructure.AzureActiveDirectory.csproj", "XML", 0, 13, 0, 0, 0, 0, 1, 14
"d:\Hexalith\Hexalith\src\Core\Infrastructure\Hexalith.Infrastructure.AzureActiveDirectory\README.md", "Markdown", 0, 0, 0, 1, 0, 0, 1, 2
"d:\Hexalith\Hexalith\src\Core\Infrastructure\Hexalith.Infrastructure.DaprAggregateActor\ActorStateStoreProvider.cs", "C#", 0, 0, 0, 0, 31, 13, 12, 56
"d:\Hexalith\Hexalith\src\Core\Infrastructure\Hexalith.Infrastructure.DaprAggregateActor\AggregateActorStateManager.cs", "C#", 0, 0, 0, 0, 118, 87, 23, 228
"d:\Hexalith\Hexalith\src\Core\Infrastructure\Hexalith.Infrastructure.DaprAggregateActor\CommandState.cs", "C#", 0, 0, 0, 0, 32, 28, 8, 68
"d:\Hexalith\Hexalith\src\Core\Infrastructure\Hexalith.Infrastructure.DaprAggregateActor\EventState.cs", "C#", 0, 0, 0, 0, 32, 28, 7, 67
"d:\Hexalith\Hexalith\src\Core\Infrastructure\Hexalith.Infrastructure.DaprAggregateActor\Hexalith.Infrastructure.DaprAggregateActor.csproj", "XML", 0, 12, 0, 0, 0, 0, 1, 13
"d:\Hexalith\Hexalith\src\Core\Infrastructure\Hexalith.Infrastructure.DaprAggregateActor\MessageState.cs", "C#", 0, 0, 0, 0, 24, 35, 9, 68
"d:\Hexalith\Hexalith\src\Core\Infrastructure\Hexalith.Infrastructure.DaprAggregateActor\README.md", "Markdown", 0, 0, 0, 1, 0, 0, 1, 2
"d:\Hexalith\Hexalith\src\Core\Infrastructure\Hexalith.Infrastructure.DaprBus\DaprApplicationBus.cs", "C#", 0, 0, 0, 0, 77, 26, 14, 117
"d:\Hexalith\Hexalith\src\Core\Infrastructure\Hexalith.Infrastructure.DaprBus\EventStoreItemNotFoundException.cs", "C#", 0, 0, 0, 0, 31, 38, 11, 80
"d:\Hexalith\Hexalith\src\Core\Infrastructure\Hexalith.Infrastructure.DaprBus\Hexalith - Backup.Infrastructure.DaprBus.csproj", "XML", 0, 15, 0, 0, 0, 0, 1, 16
"d:\Hexalith\Hexalith\src\Core\Infrastructure\Hexalith.Infrastructure.DaprBus\Hexalith.Infrastructure.DaprBus.csproj", "XML", 0, 12, 0, 0, 0, 0, 1, 13
"d:\Hexalith\Hexalith\src\Core\Infrastructure\Hexalith.Infrastructure.DaprBus\README.md", "Markdown", 0, 0, 0, 1, 0, 0, 1, 2
"d:\Hexalith\Hexalith\src\Core\Infrastructure\Hexalith.Infrastructure.DaprHandlers\ActorCommandEnvelope.cs", "C#", 0, 0, 0, 0, 17, 23, 7, 47
"d:\Hexalith\Hexalith\src\Core\Infrastructure\Hexalith.Infrastructure.DaprHandlers\CommandDispatcher.cs", "C#", 0, 0, 0, 0, 42, 28, 13, 83
"d:\Hexalith\Hexalith\src\Core\Infrastructure\Hexalith.Infrastructure.DaprHandlers\ConventionNamingCommandProcessor.cs", "C#", 0, 0, 0, 0, 21, 18, 8, 47
"d:\Hexalith\Hexalith\src\Core\Infrastructure\Hexalith.Infrastructure.DaprHandlers\Helpers\DaprHandlersHelper.cs", "C#", 0, 0, 0, 0, 12, 14, 5, 31
"d:\Hexalith\Hexalith\src\Core\Infrastructure\Hexalith.Infrastructure.DaprHandlers\Hexalith.Infrastructure.DaprHandlers.csproj", "XML", 0, 12, 0, 0, 0, 0, 1, 13
"d:\Hexalith\Hexalith\src\Core\Infrastructure\Hexalith.Infrastructure.DaprHandlers\README.md", "Markdown", 0, 0, 0, 1, 0, 0, 1, 2
"d:\Hexalith\Hexalith\src\Core\Infrastructure\Hexalith.Infrastructure.DaprMessageStore\ActorMessageStore.cs", "C#", 0, 0, 0, 0, 122, 65, 27, 214
"d:\Hexalith\Hexalith\src\Core\Infrastructure\Hexalith.Infrastructure.DaprMessageStore\Hexalith.Infrastructure.DaprMessageStore.csproj", "XML", 0, 12, 0, 0, 0, 0, 1, 13
"d:\Hexalith\Hexalith\src\Core\Infrastructure\Hexalith.Infrastructure.DaprMessageStore\MessageStoreItemNotFoundException.cs", "C#", 0, 0, 0, 0, 31, 38, 11, 80
"d:\Hexalith\Hexalith\src\Core\Infrastructure\Hexalith.Infrastructure.DaprMessageStore\README.md", "Markdown", 0, 0, 0, 1, 0, 0, 1, 2
"d:\Hexalith\Hexalith\src\Core\Infrastructure\Hexalith.Infrastructure.Dynamics365FinanceAndOperations.TestMocks\Dynamics365FinanceAndOperationsClientBuilder.cs", "C#", 0, 0, 0, 0, 50, 33, 13, 96
"d:\Hexalith\Hexalith\src\Core\Infrastructure\Hexalith.Infrastructure.Dynamics365FinanceAndOperations.TestMocks\Dynamics365FinanceAndOperationsSecurityContextBuilder.cs", "C#", 0, 0, 0, 0, 35, 22, 9, 66
"d:\Hexalith\Hexalith\src\Core\Infrastructure\Hexalith.Infrastructure.Dynamics365FinanceAndOperations.TestMocks\Hexalith.Infrastructure.Dynamics365FinanceAndOperations.TestMocks.csproj", "XML", 0, 12, 0, 0, 0, 0, 1, 13
"d:\Hexalith\Hexalith\src\Core\Infrastructure\Hexalith.Infrastructure.Dynamics365FinanceAndOperations.TestMocks\README.md", "Markdown", 0, 0, 0, 1, 0, 0, 1, 2
"d:\Hexalith\Hexalith\src\Core\Infrastructure\Hexalith.Infrastructure.Dynamics365FinanceAndOperations\BusinessEvents\Dynamics365BusinessEventBase.cs", "C#", 0, 0, 0, 0, 95, 77, 29, 201
"d:\Hexalith\Hexalith\src\Core\Infrastructure\Hexalith.Infrastructure.Dynamics365FinanceAndOperations\BusinessEvents\Dynamics365BusinessEventValidator.cs", "C#", 0, 0, 0, 0, 18, 11, 4, 33
"d:\Hexalith\Hexalith\src\Core\Infrastructure\Hexalith.Infrastructure.Dynamics365FinanceAndOperations\Client\Dynamics365FinanceAndOperationsClient.cs", "C#", 0, 0, 0, 0, 154, 102, 34, 290
"d:\Hexalith\Hexalith\src\Core\Infrastructure\Hexalith.Infrastructure.Dynamics365FinanceAndOperations\Client\Dynamics365FinanceAndOperationsClient{Get}.cs", "C#", 0, 0, 0, 0, 165, 25, 25, 215
"d:\Hexalith\Hexalith\src\Core\Infrastructure\Hexalith.Infrastructure.Dynamics365FinanceAndOperations\Client\Dynamics365FinanceAndOperationsClient{Patch}.cs", "C#", 0, 0, 0, 0, 99, 15, 14, 128
"d:\Hexalith\Hexalith\src\Core\Infrastructure\Hexalith.Infrastructure.Dynamics365FinanceAndOperations\Client\Dynamics365FinanceAndOperationsClient{Post}.cs", "C#", 0, 0, 0, 0, 77, 13, 12, 102
"d:\Hexalith\Hexalith\src\Core\Infrastructure\Hexalith.Infrastructure.Dynamics365FinanceAndOperations\Client\Dynamics365FinancePatchException.cs", "C#", 0, 0, 0, 0, 59, 54, 18, 131
"d:\Hexalith\Hexalith\src\Core\Infrastructure\Hexalith.Infrastructure.Dynamics365FinanceAndOperations\Client\Dynamics365FinancePostException.cs", "C#", 0, 0, 0, 0, 59, 54, 18, 131
"d:\Hexalith\Hexalith\src\Core\Infrastructure\Hexalith.Infrastructure.Dynamics365FinanceAndOperations\Client\GetSingleRequestFailedException.cs", "C#", 0, 0, 0, 0, 35, 55, 13, 103
"d:\Hexalith\Hexalith\src\Core\Infrastructure\Hexalith.Infrastructure.Dynamics365FinanceAndOperations\Client\IDynamics365FinanceAndOperationsClient.cs", "C#", 0, 0, 0, 0, 34, 183, 31, 248
"d:\Hexalith\Hexalith\src\Core\Infrastructure\Hexalith.Infrastructure.Dynamics365FinanceAndOperations\Configurations\Dynamics365FinanceAndOperationsClientSettings.cs", "C#", 0, 0, 0, 0, 13, 30, 6, 49
"d:\Hexalith\Hexalith\src\Core\Infrastructure\Hexalith.Infrastructure.Dynamics365FinanceAndOperations\Controllers\Dynamics365FinanceBindingController.cs", "C#", 0, 0, 0, 0, 49, 25, 12, 86
"d:\Hexalith\Hexalith\src\Core\Infrastructure\Hexalith.Infrastructure.Dynamics365FinanceAndOperations\Dispatchers\Dynamics365FinanceIntegrationEventProcessor.cs", "C#", 0, 0, 0, 0, 58, 25, 12, 95
"d:\Hexalith\Hexalith\src\Core\Infrastructure\Hexalith.Infrastructure.Dynamics365FinanceAndOperations\Dispatchers\IDynamics365FinanceIntegrationEventProcessor.cs", "C#", 0, 0, 0, 0, 8, 14, 6, 28
"d:\Hexalith\Hexalith\src\Core\Infrastructure\Hexalith.Infrastructure.Dynamics365FinanceAndOperations\Helpers\Dynamics365BusinessEventHelper.cs", "C#", 0, 0, 0, 0, 21, 18, 6, 45
"d:\Hexalith\Hexalith\src\Core\Infrastructure\Hexalith.Infrastructure.Dynamics365FinanceAndOperations\Helpers\Dynamics365FinanceAndOperationsClientHelper.cs", "C#", 0, 0, 0, 0, 18, 21, 5, 44
"d:\Hexalith\Hexalith\src\Core\Infrastructure\Hexalith.Infrastructure.Dynamics365FinanceAndOperations\Hexalith.Infrastructure.Dynamics365FinanceAndOperations.csproj", "XML", 0, 21, 0, 0, 0, 0, 3, 24
"d:\Hexalith\Hexalith\src\Core\Infrastructure\Hexalith.Infrastructure.Dynamics365FinanceAndOperations\Models\ErrorMessage.cs", "C#", 0, 0, 0, 0, 13, 20, 6, 39
"d:\Hexalith\Hexalith\src\Core\Infrastructure\Hexalith.Infrastructure.Dynamics365FinanceAndOperations\Models\ErrorResponse.cs", "C#", 0, 0, 0, 0, 9, 12, 4, 25
"d:\Hexalith\Hexalith\src\Core\Infrastructure\Hexalith.Infrastructure.Dynamics365FinanceAndOperations\Models\ICommonFilter.cs", "C#", 0, 0, 0, 0, 4, 8, 3, 15
"d:\Hexalith\Hexalith\src\Core\Infrastructure\Hexalith.Infrastructure.Dynamics365FinanceAndOperations\Models\ICommonPrimaryKey.cs", "C#", 0, 0, 0, 0, 4, 8, 3, 15
"d:\Hexalith\Hexalith\src\Core\Infrastructure\Hexalith.Infrastructure.Dynamics365FinanceAndOperations\Models\IFilter.cs", "C#", 0, 0, 0, 0, 4, 8, 3, 15
"d:\Hexalith\Hexalith\src\Core\Infrastructure\Hexalith.Infrastructure.Dynamics365FinanceAndOperations\Models\IODataElement.cs", "C#", 0, 0, 0, 0, 7, 18, 4, 29
"d:\Hexalith\Hexalith\src\Core\Infrastructure\Hexalith.Infrastructure.Dynamics365FinanceAndOperations\Models\IPerCompanyFilter.cs", "C#", 0, 0, 0, 0, 5, 12, 3, 20
"d:\Hexalith\Hexalith\src\Core\Infrastructure\Hexalith.Infrastructure.Dynamics365FinanceAndOperations\Models\IPerCompanyPrimaryKey.cs", "C#", 0, 0, 0, 0, 5, 12, 3, 20
"d:\Hexalith\Hexalith\src\Core\Infrastructure\Hexalith.Infrastructure.Dynamics365FinanceAndOperations\Models\IPrimaryKey.cs", "C#", 0, 0, 0, 0, 4, 8, 3, 15
"d:\Hexalith\Hexalith\src\Core\Infrastructure\Hexalith.Infrastructure.Dynamics365FinanceAndOperations\Models\ODataArrayResponse.cs", "C#", 0, 0, 0, 0, 16, 34, 6, 56
"d:\Hexalith\Hexalith\src\Core\Infrastructure\Hexalith.Infrastructure.Dynamics365FinanceAndOperations\Models\ODataElement.cs", "C#", 0, 0, 0, 0, 18, 19, 6, 43
"d:\Hexalith\Hexalith\src\Core\Infrastructure\Hexalith.Infrastructure.Dynamics365FinanceAndOperations\Models\PerCompanyFilter.cs", "C#", 0, 0, 0, 0, 14, 15, 5, 34
"d:\Hexalith\Hexalith\src\Core\Infrastructure\Hexalith.Infrastructure.Dynamics365FinanceAndOperations\Models\PerCompanyPrimaryKey.cs", "C#", 0, 0, 0, 0, 14, 15, 5, 34
"d:\Hexalith\Hexalith\src\Core\Infrastructure\Hexalith.Infrastructure.Dynamics365FinanceAndOperations\README.md", "Markdown", 0, 0, 0, 1, 0, 0, 1, 2
"d:\Hexalith\Hexalith\src\Core\Infrastructure\Hexalith.Infrastructure.Dynamics365FinanceAndOperations\Security\Dynamics365FinanceAndOperationsSecurityContext.cs", "C#", 0, 0, 0, 0, 29, 21, 8, 58
"d:\Hexalith\Hexalith\src\Core\Infrastructure\Hexalith.Infrastructure.Dynamics365FinanceAndOperations\Security\IDynamics365FinanceAndOperationsSecurityContext.cs", "C#", 0, 0, 0, 0, 6, 20, 4, 30
"d:\Hexalith\Hexalith\src\Core\Infrastructure\Hexalith.Infrastructure.Dynamics365FinanceAndOperations\Services\CustomerGroups\CustomerGroup.cs", "C#", 0, 0, 0, 0, 21, 14, 4, 39
"d:\Hexalith\Hexalith\src\Core\Infrastructure\Hexalith.Infrastructure.Dynamics365FinanceAndOperations\Services\CustomerGroups\CustomerGroupCreate.cs", "C#", 0, 0, 0, 0, 45, 5, 15, 65
"d:\Hexalith\Hexalith\src\Core\Infrastructure\Hexalith.Infrastructure.Dynamics365FinanceAndOperations\Services\CustomerGroups\CustomerGroupKey.cs", "C#", 0, 0, 0, 0, 7, 18, 4, 29
"d:\Hexalith\Hexalith\src\Core\Infrastructure\Hexalith.Infrastructure.Dynamics365FinanceAndOperations\Services\CustomerGroups\CustomerGroupUpdate.cs", "C#", 0, 0, 0, 0, 41, 17, 14, 72
"d:\Hexalith\Hexalith\src\Core\Infrastructure\Hexalith.Infrastructure.Security.Abstractions\Hexalith.Infrastructure.Security.Abstractions.csproj", "XML", 0, 5, 0, 0, 0, 0, 1, 6
"d:\Hexalith\Hexalith\src\Core\Infrastructure\Hexalith.Infrastructure.Security.Abstractions\IApplicationSecurityContext.cs", "C#", 0, 0, 0, 0, 5, 14, 2, 21
"d:\Hexalith\Hexalith\src\Core\Infrastructure\Hexalith.Infrastructure.Security.Abstractions\README.md", "Markdown", 0, 0, 0, 1, 0, 0, 1, 2
"d:\Hexalith\Hexalith\src\Core\Infrastructure\Hexalith.Infrastructure.Serialization\Helpers\SerializationHelper.cs", "C#", 0, 0, 0, 0, 14, 14, 4, 32
"d:\Hexalith\Hexalith\src\Core\Infrastructure\Hexalith.Infrastructure.Serialization\Hexalith.Infrastructure.Serialization.csproj", "XML", 0, 10, 0, 0, 0, 0, 1, 11
"d:\Hexalith\Hexalith\src\Core\Infrastructure\Hexalith.Infrastructure.Serialization\PolymorphicTypeResolver.cs", "C#", 0, 0, 0, 0, 26, 10, 8, 44
"d:\Hexalith\Hexalith\src\Core\Infrastructure\Hexalith.Infrastructure.Serialization\README.md", "Markdown", 0, 0, 0, 7, 0, 0, 1, 8
"d:\Hexalith\Hexalith\src\Core\Infrastructure\Hexalith.Infrastructure.Serialization\TypeNamePolymorphismOptions.cs", "C#", 0, 0, 0, 0, 62, 22, 15, 99
"d:\Hexalith\Hexalith\src\Core\Infrastructure\Hexalith.Infrastructure.WebApis\Controllers\BindingController.cs", "C#", 0, 0, 0, 0, 73, 25, 16, 114
"d:\Hexalith\Hexalith\src\Core\Infrastructure\Hexalith.Infrastructure.WebApis\Helpers\WebApiHelper.cs", "C#", 0, 0, 0, 0, 29, 14, 7, 50
"d:\Hexalith\Hexalith\src\Core\Infrastructure\Hexalith.Infrastructure.WebApis\Hexalith.Infrastructure.WebApis.csproj", "XML", 0, 18, 0, 0, 0, 0, 2, 20
"d:\Hexalith\Hexalith\src\Core\Infrastructure\Hexalith.Infrastructure.WebApis\README.md", "Markdown", 0, 0, 0, 1, 0, 0, 1, 2
"d:\Hexalith\Hexalith\src\Core\Infrastructure\README.md", "Markdown", 0, 0, 0, 5, 0, 0, 2, 7
"d:\Hexalith\Hexalith\src\Core\README.md", "Markdown", 0, 0, 0, 7, 0, 0, 1, 8
"d:\Hexalith\Hexalith\src\Directory.Build.props", "XML", 0, 31, 0, 0, 0, 0, 1, 32
"d:\Hexalith\Hexalith\src\Hexalith.Build\Dependencies.props", "XML", 0, 5, 0, 0, 0, 0, 1, 6
"d:\Hexalith\Hexalith\src\Hexalith.Build\Project.Common.props", "XML", 0, 15, 0, 0, 0, 5, 6, 26
"d:\Hexalith\Hexalith\src\README.md", "Markdown", 0, 0, 0, 2, 0, 0, 3, 5
"d:\Hexalith\Hexalith\test\Directory.Build.props", "XML", 0, 23, 0, 0, 0, 0, 1, 24
"d:\Hexalith\Hexalith\test\Hexalith.IntegrationTests\Dynamics365Finance\CustomerGroupTest.cs", "C#", 0, 0, 0, 0, 90, 5, 15, 110
"d:\Hexalith\Hexalith\test\Hexalith.IntegrationTests\Hexalith.IntegrationTests.csproj", "XML", 0, 31, 0, 0, 0, 0, 1, 32
"d:\Hexalith\Hexalith\test\Hexalith.IntegrationTests\Usings.cs", "C#", 0, 0, 0, 0, 3, 5, 2, 10
"d:\Hexalith\Hexalith\test\Hexalith.IntegrationTests\appsettings.json", "JSON", 0, 0, 19, 0, 0, 0, 0, 19
"d:\Hexalith\Hexalith\test\Hexalith.UnitTests\Core\Application\Envelopes\DummyMetadata.cs", "C#", 0, 0, 0, 0, 33, 5, 6, 44
"d:\Hexalith\Hexalith\test\Hexalith.UnitTests\Core\Application\Tasks\MetadataTest.cs", "C#", 0, 0, 0, 0, 37, 5, 8, 50
"d:\Hexalith\Hexalith\test\Hexalith.UnitTests\Core\Application\Tasks\ResiliencyPolicyTest.cs", "C#", 0, 0, 0, 0, 74, 6, 8, 88
"d:\Hexalith\Hexalith\test\Hexalith.UnitTests\Core\Application\Tasks\TaskProcessingHistoryTest.cs", "C#", 0, 0, 0, 0, 61, 5, 9, 75
"d:\Hexalith\Hexalith\test\Hexalith.UnitTests\Core\Application\Tasks\TaskProcessorTest.cs", "C#", 0, 0, 0, 0, 82, 5, 13, 100
"d:\Hexalith\Hexalith\test\Hexalith.UnitTests\Core\Common\Common\ConditionalValueTest.cs", "C#", 0, 0, 0, 0, 33, 28, 14, 75
"d:\Hexalith\Hexalith\test\Hexalith.UnitTests\Core\Common\Configuration\ConfigureSettingsTest.cs", "C#", 0, 0, 0, 0, 40, 6, 12, 58
"d:\Hexalith\Hexalith\test\Hexalith.UnitTests\Core\Common\Exceptions\ExceptionHelperTest.cs", "C#", 0, 0, 0, 0, 25, 5, 7, 37
"d:\Hexalith\Hexalith\test\Hexalith.UnitTests\Core\Common\Helpers\ArrayHelperTest.cs", "C#", 0, 0, 0, 0, 36, 5, 7, 48
"d:\Hexalith\Hexalith\test\Hexalith.UnitTests\Core\Common\Helpers\ExceptionHelperTest.cs", "C#", 0, 0, 0, 0, 24, 5, 6, 35
"d:\Hexalith\Hexalith\test\Hexalith.UnitTests\Core\Common\Helpers\ObjectToDictionnaryHelper.cs", "C#", 0, 0, 0, 0, 27, 6, 8, 41
"d:\Hexalith\Hexalith\test\Hexalith.UnitTests\Core\Common\Helpers\StringHelperTest.cs", "C#", 0, 0, 0, 0, 87, 5, 13, 105
"d:\Hexalith\Hexalith\test\Hexalith.UnitTests\Core\Common\Helpers\UniqueHelperTest.cs", "C#", 0, 0, 0, 0, 49, 5, 11, 65
"d:\Hexalith\Hexalith\test\Hexalith.UnitTests\Core\Common\Maths\FibonacciTest.cs", "C#", 0, 0, 0, 0, 24, 5, 4, 33
"d:\Hexalith\Hexalith\test\Hexalith.UnitTests\Core\Domain\DummyBaseEvent.cs", "C#", 0, 0, 0, 0, 22, 5, 8, 35
"d:\Hexalith\Hexalith\test\Hexalith.UnitTests\Core\Domain\DummyEvent1.cs", "C#", 0, 0, 0, 0, 22, 5, 8, 35
"d:\Hexalith\Hexalith\test\Hexalith.UnitTests\Core\Domain\DummyEvent2.cs", "C#", 0, 0, 0, 0, 22, 5, 8, 35
"d:\Hexalith\Hexalith\test\Hexalith.UnitTests\Core\Infrastructure\DaprBus\DaprApplicationBusTest.cs", "C#", 0, 0, 0, 0, 37, 5, 8, 50
"d:\Hexalith\Hexalith\test\Hexalith.UnitTests\Core\Infrastructure\DaprEventStore\ActorEventStoreTest.cs", "C#", 0, 0, 0, 0, 283, 5, 31, 319
"d:\Hexalith\Hexalith\test\Hexalith.UnitTests\Core\Infrastructure\DaprEventStore\BaseTestEvent.cs", "C#", 0, 0, 0, 0, 30, 5, 10, 45
"d:\Hexalith\Hexalith\test\Hexalith.UnitTests\Core\Infrastructure\DaprEventStore\BaseTestEvent2.cs", "C#", 0, 0, 0, 0, 14, 5, 6, 25
"d:\Hexalith\Hexalith\test\Hexalith.UnitTests\Core\Infrastructure\Dynamics365Finance\BusinessEvents\BusinessEventTest.cs", "C#", 0, 0, 0, 0, 63, 6, 9, 78
"d:\Hexalith\Hexalith\test\Hexalith.UnitTests\Core\Infrastructure\Dynamics365Finance\BusinessEvents\DummyBusinessEvent.cs", "C#", 0, 0, 0, 0, 27, 5, 12, 44
"d:\Hexalith\Hexalith\test\Hexalith.UnitTests\Core\Infrastructure\Dynamics365Finance\Client\DummyEntity.cs", "C#", 0, 0, 0, 0, 16, 5, 7, 28
"d:\Hexalith\Hexalith\test\Hexalith.UnitTests\Core\Infrastructure\Dynamics365Finance\Client\Dynamics365FinanceAndOperationsClientMockTest.cs", "C#", 0, 0, 0, 0, 27, 5, 6, 38
"d:\Hexalith\Hexalith\test\Hexalith.UnitTests\Core\Infrastructure\Dynamics365Finance\Client\Dynamics365FinanceAndOperationsClientTest.cs", "C#", 0, 0, 0, 0, 63, 27, 9, 99
"d:\Hexalith\Hexalith\test\Hexalith.UnitTests\Core\Infrastructure\Dynamics365Finance\Client\ErrorMessageTest.cs", "C#", 0, 0, 0, 0, 30, 6, 7, 43
"d:\Hexalith\Hexalith\test\Hexalith.UnitTests\Core\Infrastructure\Serialization\MessageJsonTypeInfoResolverTest.cs", "C#", 0, 0, 0, 0, 105, 5, 17, 127
"d:\Hexalith\Hexalith\test\Hexalith.UnitTests\Hexalith.UnitTests.csproj", "XML", 0, 28, 0, 0, 0, 0, 1, 29
"d:\Hexalith\Hexalith\test\Hexalith.UnitTests\Usings.cs", "C#", 0, 0, 0, 0, 3, 5, 2, 10
"d:\Hexalith\Hexalith\test\Hexalith.UnitTests\appsettings.json", "JSON", 0, 0, 19, 0, 0, 0, 0, 19
"Total", "-", 191, 391, 56, 216, 5471, 3809, 1627, 11761